##########
#P    & ##
# # #    #
#    ## ##
# &     &#
#    #   #
##       E
#  #     #
# &  #&  #
##########